neglecting reality and the outside world leads to misery -- пренебрежение реальностью и внешним миром ведёт к нищете (страданию)

I got greedy and demanding. -- Я стал жадным и требовательным

prosperous company -- процветающая компания

to fulfill dreams -- осуществлять мечты

This works as follows:... -- Это работает следующим образом:...

I won't interfere, Gerry added -- Я не помешаю, добавил Джерри

to admit guilt, to admit defeat -- признать вину, признать поражение

the peninsula's western extremity -- западная оконечность полуострова

to be deeply involved in criminal / questionable activity -- активно участвовать (быть глубоко вовлечённым) в криминальной / сомнительной деятельности

a subject with many intricate problems and pitfalls -- предмет со множеством запутанных проблем и подводных камней

to investigate -- исследовать, изучать

patience and tenacity -- терпение и (упорство / выдержка)

I embody the central paradox -- Я олицетворяю основной парадокс

In those heady days... -- В те пьянящие дни..

skill of making eye contact -- умение держать зрительный контакт (глаза в глаза)

grief at the funerals -- горе на похоронах

capacity for self-reflection -- способность к рефлексии

I can't get enough of this new TV show. -- Не могу насмотреться этого нового сериала.

to retouch -- ретушировать

catch someone off guard -- застать кого-то в расплох

all those little sips of smth.1 add up to one big gulp of smth.2 - все эти маленькие частички (глоточки) чего-то одного складываются в одно большое целое (большой глоток) чего-то другого

elderly -- престарелые, пожилые (прил., сущ.)

confidence -- уверенность, доверие

to comfort -- утешать, успокаивать

one of the most wrenching, complicated moments in my 15 years of work -- один из самых мучительных, сложных моментов за мои 15 лет работы

technology appeals to us most where we are most vulnerable -- технологии взывают к нам (притягивают, привлекают нас) больше, когда мы более уязвимы.

to get on well with smbd. -- хорошо ладить с кем-то

to keep in touch with smbd. -- поддерживать связь с кем-то

to lose touch with smbd. -- терять связь с кем-то

to make an excuse (for) -- извиняться (за)

to get rid of -- избавляться от

front/rear brake -- передний/задний тормоз

the slack season in an industry -- мёртвый (вялый) сезон в индустрии

economic (situation) - economical (car) -- экономическая ситуация - экономичная машина

historic (moment) - historical (fact) -- исторический момент - исторический факт

Great careers are really just a matter of luck. -- Великие карьеры - это в действительности вопрос удачи (дело случая).

my professors have beaten that idea out of my head -- мои профессора выбили эту идею из моей головы

wretched weakling -- жалкий слабак

to neglect the family -- пренебрегать семьёй

she plants only cacti -- она выращивает только кактусы (занимается только ими)

willingly sign your own death warrant -- намеренно подписывать собственный смертельный приговор

without the need for resorting to the trick -- без необходимости прибегать к этому приёму (трюку)

fishmonger’s -— Рыбный магазин

butcher’s —- Мясной магазин

greengrocer’s -- Овощной магазин

market (place) -— Рынок

department store -— Универсальный магазин, универмаг

liquor store —- Алкогольный магазин

shoe store -— Обувной магазин

self-service store -— Магазин самообслуживания

furniture store -— Мебельный магазин