punchline -- кульминация

old man nursing a beer -- старик, посасывающий пиво

to fill smbd. in on your life -- посвятить кого-то в свою жизнь (ввести в курс дела)

smth. that she was never realy able to recovered from -- что-то, от чего она так и не смогла в действительности оправиться

comprehensive article -- всесторонняя/исчерпывающая статья

that can be daunting/intimidating/frightening -- это может быть пугающим/обескураживающим (3 вар.)

stand by me -- останься со мной

overwhelming majority of people on the planet -- подавляющее большинство населения планеты

monotonous, meaningless and soul-deadening work -- монотонная, бессмысленная, убивающая душу работа

engaging, stimulating and meaningful work -- занимательная, стимулирующая и наполненная смыслом работа

premises and consequences -- предпосылки и последствия

vague responsibility separation is bad -- неясное (расплывчатое) разделение обязанностей - это плохо

pursue both goals -- преследовать обе цели

to wrap up = to finish -- заканчивать, закругляться

ill-treated animals -- животные, с которыми плохо обращались

delicious dishes -- очень вкусные (изысканные) блюда

jubilant crowds -- ликующие толпы

negotiation can be intimidating -- переговоры могут быть пугающими

wherever I happen to be -- везде, где я оказываюсь

refugees -- беженцы

the little girl who arises out of their union -- маленькая девочка, которая возникает из этого союза

this gossips are slightly exaggerated -- эти слухи слегка преувеличены

on time - in time -- в назначенное время - к назначенному сроку, заблаговременно

a loose end of the rope -- свободный конец верёвки

to reveal a secret -- открыть/раскрыть секрет

to purse (морщить) (up) one's mouth -- поджать губы

to be numbered with... -- быть причисленным к...

harmless fun -- безобидное веселье

all of a sudden / suddenly -- неожиданно, внезапно

twenty-storey building -- двадцатиэтажное строение

to set up/to establish an organisation -- основать организацию

learning is necessary but insufficient -- обучение необходимо, но не достаточно

nifty coding tricks -- остроумные/модные ухищрения в коде

embrace the new -- принимать всё новое

use this principles to evaluate new ideas -- используйте эти принципы для оценки новых идей

magnifying glass of science -- увеличительное стекло науки

novel technologies, not foreseen or anticipated by nature - новые/оригинальные технологии, не предусмотренные или предполагаемые природой

to bridge the gap between disability and ability -- преодолеть пропасть между неспособностью и способностью

artificial limb -- искусственная конечность

prosthetic leg -- протез ноги

to extend beyond biological capability -- расширяться за пределы биологических возможностей

Technology eliminated my disability -- Техника уничтожила мою инвалидность

trait -- черта характера

solitary -- одинокий, уединённый

The problem might not be evident until... -- Проблема может быть неочевидной, пока...

to evaluate the fruits of our labor -- оценивать плоды нашей работы

rats in a maze / guinea pigs -- подопытные кролики (2 вар)

tremendously -- чрезвычайно

tangible and intangible values -- материальные и нематериальные ценности

notion -- понятние, представление

And indeed, this is a great example. -- И это действительно хороший пример.