to take offence -- обидеться

to take a nap -- вздремнуть

to hit the target -- попасть в цель

to put an end to -- положить конец, преодолеть

the root of the trouble -- корень зла

to read between lines -- читать между строк

to take into account -- принимать во внимание

to make a point -- обратить особое внимание

to jump at conclusions -- делать поспешные выводы 

help yourself -- угощайся 

to make a decision -- принимать решение

to achieve results -- добиться результатов

draw (smb's) attention -- обращать внимание (чье-то)

moment of silence -- минута молчания

ups-and-downs -- взлеты и падения

trouble shooter -- специалист по разрешению конфликтных ситуаций

at the world's end -- на краю света

think tank -- мозговой центр

a desperate desire -- отчаянное желание

a close-knit family (knit - вязать) -- сплочённая семья

(to take / to attend) the course -- посещать курс (2 вар)

(to teach / to lead) a course -- вести курс (2 вар)

in order to clinch that deal -- для того, чтобы закрыть сделку

(to toss / to flip) a coin -- подбросить монетку (2 вар)

on behalf of smbd. -- от лица / от имени кого-то, для кого-то

surveys and polls -- опросы и голосования

imposter syndrome -- синдром самозванца

that's the conundrum -- вот в чём задачка (головоломка)

to patch up -- чинить, подлатать

On the spur of the moment -- под влиянием момента 

Once and for all -- однажды и навсегда 

to save face -- спасать репутацию 

Show promise -- подавать надежды 

Lucky break -- счастливый случай

tangible benefit -- ощутимая выгода

bouncing ideas off of coworkers -- проба идей на коллегах по работе

irreplaceability of face-to-face communication -- незаменимость общения лицом-к-лицу

to master the art of remote work -- овладеть искусством удалённой работы

to aspire / to aim -- стремиться (2 вар)

an attempt is not a torture -- попытка - не пытка

moral ambiguity -- нравственная неоднозначность (двусмысленность)

slippery slope -- скользкий уклон (склон)

wipping boy -- мальчик для битья

it makes your code more readable and less prone to bugs -- это делает ваш код более читаемым и менее склонным к багам

conference that will be held next month -- конференция, которая будет проведена в следующем месяце

he has the whole eternity ahead -- у него впереди целая вечность

the greatest commandment of storytellers -- главная заповедь рассказчиков