After Apple unveiled the Swift programming language, it quickly became one of the fastest growing languages in history. -- После того, как Эппл открыл Свифт, он в скором времени стал одним из самых быстро развивающихся языков в истории

learning is necessary but insufficient -- необходимо, но не достаточно

nifty coding tricks -- остроумные/модные ухищрения в коде

embrace the new -- принимать всё новое

use this principles to evaluate new ideas -- используйте эти принципы для оценки новых идей

Do you think ... or vice versa? -- Думаешь... или наоборот?

magnifying glass of science -- увеличительное стекло науки

novel technologies, not foreseen or anticipated by nature - новые/оригинальные технологии, не предусмотренные или предполагаемые природой

Bionics explores the interplay between biology and design
to bridge the gap between disability and ability -- преодолеть пропасть между неспособностью и способностью

artificial limb -- искусственная конечность

prosthetic leg -- протез ноги

to extend beyond biological capability -- расширяться за пределы биологических возможностей

Technology eliminated my disability -- Техника уничтожила мою инвалидность

Bionic limbs have been fitted to nearly 1,000 patients -- Бионические конечности были установлены примерно тысяче пациентов.

trait -- черта характера

solitary -- одинокий, уединённый

The problem might not be evident until... -- Проблема может быть неочевидной, пока...

to evaluate the fruits of our labor -- оценивать плоды нашей работы

rats in a maze -- подопытный кролик

tremendously -- чрезвычайно

tangible and intangible values -- материальные и нематериальные ценности

notion -- понятние, представление

Adam Smith had a very important notion of efficiency. -- Адам Смит дал очень вашное определение эффективности.

And indeed, this is a great example. -- И это действительно хороший пример.

tremendous, huge, enormous -- огромный

Why ever resign and leave corporate heaven? -- Зачем вообще увольняться и покидать корпоративные небеса?

neglecting reality and the outside world leads to misery -- пренебрежение реальностью и внешним миром ведёт к нищете (страданию)

chocolate sprinkle -- шоколадная посыпка (на мороженом, например)

I got greedy and demanding. -- Я стал жадным и требовательным

prosperous company -- процветающая компания

to fulfill dreams -- осуществлять мечты

This works as follows:... -- Это работает следующим образом:...

Don't confuse love with pity! -- Не путай любовь с жалостью!

Just don't let her interfere with the business -- Просто не позволяй ей межать бизнесу

I won't interfere, Gerry added -- Я не помешаю, добавил Джерри

to brush hair -- расчёсывать волосы

to brush teeth -- чистить зубы

to make the bed -- запрвлять кровать

to squat -- сидеть на корточках

to wave -- махать рукой

to yawn -- зевать

to lament -- сетовать, жаловаться

to say wistfully -- сказать задумчиво (мечтательно)

a subject with many intricate problems and pitfalls -- предмет со множеством запутанных проблем и подводных камней

to investigate -- исследовать, изучать

patience and tenacity -- терпение и упорство

I embody the central paradox -- Я олицетворяю основной парадокс

In those heady days... -- В те пьянящие дни..

I've just written a new book, but this time it's not one that will get me on the cover of Wired magazine. -- Я только что написала новую книгу, но на этот раз она не выведет меня на обложку Wired.

skill of making eye contact -- умение держать зрительный контакт (глаза в глаза)

grief at the funerals -- горе на похоронах

capacity for self-reflection -- способность к рефлексии

I can't get enough of this new TV show. -- Не могу насмотреться этого нового сериала.

to retouch -- ретушировать

catch someone off guard -- застать кого-то в расплох

all those little sips of smth.1 add up to one big gulp of smth.2 - все эти маленькие частички (глоточки) чего-то одного складываются в одно большое целое (большой глоток) чего-то другого

elderly -- престарелые, пожилые (прил., сущ.)

confidence -- уверенность, доверие

to comfort -- утешать, успокаивать

one of the most wrenching, complicated moments in my 15 years of work -- один из самых мучительных, сложных моментов за мои 15 лет работы

technology appeals to us most where we are most vulnerable -- технологии взывают к нам (притягивают, привлекают нас) больше, когда мы более уязвимы.

This idea changes our psyches -- Эта идея меняет нашу психику

a profound question -- личный вопрос

Start thinking of solitude as a good thing -- Начните думать об одиночестве, как о чём-то хорошем

When we stumble or hesitate or lose our words we reveal ourselves to each other -- Когда мы спотыкаемся, или колеблемся, или не находим слов, мы открываемся друг другу

