// FOODSTUFFS
almond, peanut, walnut, pistachios, cashew -- миндаль, арахис, грецкий орех, кешью

apricots, peaches, pears and tangerines -- абрикосы, персики, груши и мандарины

bilberry, blackberry, gooseberry, rasberry, currant -- черника, ежевика, крыжовник, малина, смородина

bread-crumbs, rusk/sea biscuit/ship's biscuit -- панировочные сухари, сухарь (3 вар)

buckwheat, semolina -- гречка и маннка

bun, chocolates, sweets/candies -- сдобная булка, шоколадные конфеты, конфеты

cauliflower -- цветная капуста

chicken-broth -- куринный бульон

broth / clear soup -- бульон

chop -- отбивная

vanilla and cinnamon -- ваниль и корица

cod/codfish, eel, herring, mackerel, trout, bream -- треска, угорь, сельдь, скумбрия, форель, лещ

corn-cob -- кукурузный початок

crumbs -- крошки

dressing -- соус к салату

filling -- начинка

flour -- мука

ginger -- имбирь

gingerbread -- имбирный пряник

goose, geese -- гусь, гуси

gravy -- мясная подлива

radish -- редис

horse-radish -- хрен

hunk -- ломоть, большой кусок

kidneys, liver and ribs -- почки, печень и рёбра

lean meat -- постное мясо, мясо без жира

mashed potatoes -- пюре

meatballs -- котлетки, фрикадельки

mince(d) meat -- фарш

mustard -- горчица

beef - veal, mutton - lamb -- говядина - телятина, баранина - ягнятина

peas -- горох

pomegranate -- гранат

porridge -- каша

powdered sugar -- сахарная пудра

processed cheese -- плавленный сыр

raisin and prune -- изюм и чернослив

sauerkraut -- квашеная капуста

seasoning -- приправа

shell -- шелуха/скорлупа

soft-boiled/hard-boiled egg -- жидко-сваренное / полностью-сваренное яйцо

souse -- рассол

spinach -- шпинат

sprat -- килька, шпроты

thick soup -- густой суп

vinegar -- уксус

wholemeal bread -- цельнозерновой хлеб (с отрубями)

white/yolk of an egg -- белок/желток яйца




// CHARACTERISTICS
bitter -- горький
canned/tinned -- консервированный (2 вар)
dough-baked -- недопечёный
underdone -- недоготовленный
overdone -- передержаный/пережареный
undersaulted -- недосолёный
unleavened dough -- постное тесто
rich dough -- сдобное тесто
fatty -- жирный
green (green cheese) -- молодой, неспелый (молодой сыр)
nourishing / substantial -- питательный/сытный (2 вар)
ripe -- спелый
roast (beef/chicken) -- поджареная (говядина/курица)
smoked -- копчёный
stale -- чёрствый, подсохший
succulent / juicy / rich -- сочный (3 вар)
tender -- нежное, мягкое (о мясе)
tough -- жёсткий




utensils -- принадлежности
cupboard -- шкаф для посуды
cutting board -- разделочная доска
cooker -- плита
coffee maker -- кофеварка
coffee-grinder -- кофемолка
cookery-book -- поваренная книга
butter-dish -- маслёнка
ladle -- поварёшка / черпак
lid -- крышка
mug -- кружка
salt-cellar and pepper-box -- солонка и перечница
recipe -- рецепт
rolling pin -- скалка
saucepan -- кастрюля-ковш
saucer -- блюдце
sugar basin -- сахарница
sugar tongs -- щипцы для сахара
teapot -- заварочный чайник
teaspoon -- чайная ложка
thermos jug -- термос
jug -- кувшин
tin/can/tin can -- консервная банка
bottle/can opener -- открывашка для бутылок, для консервов
cork screw -- (пробковый) штопор
dish rack -- сушилка для посуды
immersion heater -- кипятильник
jar -- банка (для специй, стеклянная)
juice extractor / squeezer -- соковыжималка (2 вар)
kitchen scale -- кухонные весы
mincing-machine -- мясорубка
nutcracker -- орехокололка
tray -- поднос
grater -- тёрка
whisk -- венчик
spatula -- лопатка
(potato) peeler -- овощечистка
caserole pan --  форма для запекания
ice tray -- форма для льда
oven mitts (mittens) -- рукавицы для духовки
pot holder -- прихватка
pizza cutter -- нож для пиццы


// ACTIONS
// Preparing
to prepare a dish -- приготовить блюдо

to weigh out 100g of oats or rye -- взвесить 100гр. овса или пшеницы

to wash/​rinse the lettuce/​spinach/​watercress -- помыть/ополоснуть (2 вар) латук / шпинат / кресс

to chop dill and parsley -- измельчить укроп и петрушку

to slice a beet/beetroot -- нарезать свеклу

to dice egg-plants and vegetable marrows / squashs -- порезать кубиками баклажаны и кабачки (2 вар)

to peel/rind -- очистить от кожуры (2 вар)

to grate a carrot/​the cheese -- потереть морковь, сыр

to remove/​discard the bones/​seeds/​skin -- удалить/извлечь (2 вар) кости, семена, кожу

to blend/​combine/​mix (together) the flour and water/​all the ingredients -- смешать (3 вар) муку и воду, все ингредиенты

to beat/​whisk the cream/​eggs/​egg whites -- взбить (2 вар) сливки, яйца, белки

knead/​roll (out) the dough -- замесить / раскатать тесто

to sift -- просеять, сыпать

to pickle -- мариновать


// Cooking
to heat the oil in a frying pan -- нагреть масло на сковородке

to preheat/​heat the oven -- нагреть духовку (заранее)

to stir constantly/​gently with a wooden spoon -- постоянно/медленно помешивать деревянной ложкой

to simmer gently for 20 minutes/​until reduced by half -- держать на медленном огне 20 мин./пока не уменьшится вдвое

to drain the pasta/​the water from the pot/​in a colander -- слить пасту / воду из кастрюли / в дуршлаг

to mash the potatoes/​banana/​avocado -- размять картошку/банан/авокадо

to stuff with -- фаршировать чем-то


// Ways of cooking
to bake -- испечь, запечь

to boil -- сварить

to deep-fry potatoes and onion -- зажарить во фритюре картошку и лук
​
to stir-fry the vegetables -- зажарить на сильном огне овощи

to roast -- зажаривать

to steam spinach/​asparagus/​dumplings -- приготовить на пару шпинат, спаржу, пельмени

to stew -- тушить

to poach -- варить в небольшом кол-ве воды


// Serving
to serve in a glass/​on a bed of rice/​with potatoes -- подавать в стакане / на слое риса / с картошкой

to arrange the slices on a plate/​in a layer -- разложить нарезку на тарелке / в один слой

to carve the meat -- нарезать мясо

to dress salad with vinegar -- заправить салат уксусом

to ​drizzle salad with olive oil -- спрыснуть салат оливковым маслом

to ​toss a salad -- размешать салат

to top with a slice of lemon/​a scoop of ice cream/​whipped cream -- положить сверху ломтик лимона, шарик мороженого, взбитые сливки

to garnish with a sprig of parsley/​fresh basil leaves -- украсить веточкой петрушки, свежим базиликом

to sprinkle with freshly ground black pepper -- посыпать свежемолотым чёрным перцем

to season to taste with salt and pepper -- приправить по вкусу солью и перцем


to have a bite -- перекусить
to help oneself to -- положить себе
to keep to a diet -- придерживаться диеты
to lay the table -- накрыть на стол
to pass -- передавать что-то
to pour -- наливать
to propose a toast -- предложить тост



//OTHER
Help yourself to some cake -- Угощайся тортом! (Наложи себе сам)

Put meat to the freezer, vegetables to the crisper and spread all the other goods on the shelfs. -- Положи мясо в морозилку, овощи - в ящик холодильника и распредели все остальные продукты по полкам.

a sliced loaf -- порезанная буханка хлеба

An edible/eatable kidney-shaped nut, rich in oil and protein, which is roasted and shelled before it can be eaten. -- Cъедобный (2 вар) орех в форме почки, богатый жиром и белком, который обжаривается и очищается перед употреблением.

Leaven is a substance, typically yeast, that is added to dough to make it ferment and rise. -- Закваска - это субстанция (обычно дрожжи), добавляемая к тесту, чтобы заставить его бродить и подниматься.

Add in the flour progressively, kneading the dough until it is no longer sticky. -- Добавьляйте муку постепенно, разминая тесто пока оно не перестанет быть липким.

Put your money away - I'm going to treat you (to this). -- Убери деньги, я угощаю тебя (этим).

canteen -- столовая

confectionery -- кондитерская / кондитерские изделия

to feed on - держать на диете. She fed him on vegetables. -- Она держала его на овощной диете.

She fed him lamb (just once). -- Она покормила его ягнятиной.

Polar bears feed on seals. -- Полярные медведи питаются тюленями

My girlfriend is such a sweet tooth, that she cannot spend a day without sweets and pastries. -- Моя девушка такая сладкоежка, что не может жить без сладостей и сладкой выпечки

There're not so little proteins in plants like peas and beans. -- В растениях типа гороха и бобов содержится немало белка.

My sister prefere to eat out or bring takeaway food. She hasn't been eating home-made food for ages. -- Моя сестра предпочитает есть вне дома, или приносить еду на вынос. Она сто лет уже не ела домашней еды.

Lime is the same sour as lemon, but a bit more bitter. -- Лайм такой же кислый как лимон, только чуть горчее.

Food in this restaurant is kind of bland. -- Еда в этом заведении какая-то безвкусная. (not "tasteless", please!)

That crunchy roast chicken was so good I licked the plate clean. -- Этот хрустящий жареный циплёнок был так хорош, что я вылизал тарелку начисто.

There were baked potatoes, steamed cauliflower and beef stew on the table. -- На столе были печёный картофель, цветная капуста на пару и жаркое из говядины.

Do you prefere watter still or sparkling (fizzy)? -- Вы предпочитаете воду без газа или газированную?
